####################################################################################################
####################################################################################################
####################################################################################################
####################################################################################################
####................################################################################################
####................#####.....................######################################################
####................#####.....................######################################...............#
####...@............#####.....................######################################...............#
####................#####.....................######################################...............#
####................#####.....................######################################...............#
####................#####.....................#########........................#####...............#
####..........................................#########........................#####...............#
####..........................................#########........................#####...............#
####..........................................#########........................#####...............#
####................#####.....................#########........................#####...............#
####................#####.....................#########........................#####...............#
####................#####.....................#########........................#####...............#
####................#####.....................#########........................#####...............#
####................#####.....................#########........................#####...............#
####................#####.....................#########........................#####...............#
####................#####.....................#########........................#####...............#
####................#####.....................#########........................#####...............#
####................#####.....................#########........................#####...............#
####................#####.....................#########........................#####...............#
####................#####.....................#########........................################...##
####................#########......####################........................################...##
#############################......####################........................################...##
#############################......####################........................................#####
#############################......####################........................................#####
#############################......####################........................................#####
#############################......####################........................#####################
#############################......############################...##################################
#############################......############################...##################################
#############################......############################...##################################
#############################......############################...##################################
#############################......############################...##################################
#############################.....................######...............#############################
#############################.....................######...............#############################
#############################.....................######...............#############################
##......................#####.....................######...............######......................#
##................................................######...............######......................#
##................................................######...............######......................#
##................................................######...............######......................#
##................................................######...............######......................#
##................................................######...............######......................#
##................................................######...............######......................#
##......................#####.....................######...............######......................#
##......................#####.....................######...............######......................#
##......................#####.....................######...............######......................#
##......................#####.....................######...........................................#
##......................#####.....................######...........................................#
##......................#####.....................######...........................................#
##......................#####.....................######...............######......................#
##......................#####.....................######...............######......................#
##......................#####.....................######...............######......................#
##......................#####.....................######...............######......................#
##......................#####.....................######...............#############...#############
#############...#############......#####################...............#############...#############
#############...#############......#####################...............#############...#############
#############...#############......#####################...............#############...#############
######.............................#####################...............#############...#############
######.............................#################################################...#############
######.............................#################################################...#############
######.............................#..............##################################...#############
######.............................#..............##################################...#############
######.............................#..............##################################...#############
######.............................#..............##################################...#############
######.............................#..............##################################...#############
######.............................#..............##################################...#############
######.............................#..............##################################...#############
######............................................##################################...#############
######............................................##################################...#############
######............................................##################################...#############
######.............................#..............##################################...#############
#########...#################......#..............##################################...#############
#########...#################......#..............######................############...#############
#########...#################......#..............######................###########................#
#########...#################......#####################................###########................#
#########...#################......#####################...........................................#
#########...#################......#####################...........................................#
#########...############...........................#####...........................................#
###................#####...........................#####................###########................#
###................................................#####................###########................#
###................................................#####................###########................#
###................................................#####................###########................#
###................#####...........................#####................###########................#
###................#####...........................#####................###########................#
###................#####...........................#####................###########................#
###................#####...........................#####................###########................#
###................#####...........................#####................###########................#
###................#####...........................#####................###########................#
###................................................#####................###########................#
###................................................#####................###########................#
###................................................#####................###########................#
###................#####...........................#####...........................................#
###................#####...........................................................................#
###................#####...........................................................................#
########################................................................###########................#
########################################################................############################
####################################################################################################
