####################
####################
####################
####################
####################
##..............####
##..............####
##...bb.........####
##...b...@...g..####
##..............####
##...........b.b####
##............b.####
##.y............####
##..............####
##..............####
##..............####
##..............####
##........g..y..####
##..............####
####################
