##################################################
##################################################
##################################################
##################################################
##################################################
##################################################
##################################################
##.........................#######################
##.........................#######################
##.........................######............#####
##...@.....................######............#####
##.........................######............#####
##.............................................###
##.............................................###
##.............................................###
##.........................######..............###
##.........................######..............###
##.........................######..............###
##.........................######..............###
##.........................##############......###
########################...##############......###
########################...##############......###
########################...##############......###
########################...##############......###
########################...##############......###
########################...##############......###
########################...##############......###
########################...##############......###
########################...##############......###
########################...###########...........#
########################...###########...........#
########################...###########...........#
########################...###########...........#
########################...###########...........#
########################...###########...........#
########################...###########...........#
########################...###########...........#
########################...###########...........#
###.........................##########...........#
###.........................##########...........#
###.........................######################
###.........................######################
###.........................######################
###.........................######################
###.........................######################
###.........................######################
###.........................######################
###.........................######################
###.........................######################
##################################################
