####################################################################################################
####################################################################################################
###################################..............###################################################
###################################..............#######.................###########################
#####..............################..............#######.................###########################
#####..............################...@..........#######.................###########################
#####..............################..............#######.................####..................#####
#####..............################..............#######.................####..................#####
#####..............################..............#######.................####..................#####
#####..............################..............#######.................####..................#####
#####..............################..............#######.................####..................#####
#####..............################......................................####..................#####
#####..............################......................................####..................#####
#####..............################......................................####..................#####
#####..............################..............#######.................####..................#####
#####....................................................................####..................#####
#####....................................................................####..................#####
#####....................................................................####..................#####
###############...#################..............#######.................####..................#####
###############...######################################.................####..................#####
###############...###########################################################..................#####
###############...###########################################################..................#####
###############...############################################.................................#####
###############...############################################.................................#####
###############...############################################.................................#####
####.....................##############..............#########...############..................#####
####.....................##############..............#########...############..................#####
####.................................................#########...############..................#####
####................................................................#########..................#####
####................................................................#########..................#####
####................................................................#####################...########
####.....................##############..............#########......#####################...########
####.....................##############..............####................################...########
####.....................##############..............####................################...########
####.....................##############..............####................################...########
####.................................................####................################...########
####.................................................####................################...########
####.....................................................................################...########
####.....................................................................################...########
####.....................................................................################...########
####.....................##############..............####................####..................#####
####.....................##############..............####................####..................#####
####.....................################################................####..................#####
####.....................################################................####..................#####
####.....................################################................####..................#####
####.....................################################................####..................#####
####.....................################################................####..................#####
####.....................################################................####..................#####
####.....................################################................####..................#####
####.....................###################################...##############..................#####
####.....................###################################...##############..................#####
####.....................###################################...##############..................#####
####.....................###################################...##############..................#####
####.....................###################################...##############..................#####
####.....................###################################...#####################...##...########
####.....................###############################..............##############...##...########
################...#####################################..............##############...##...########
################...#####################################..............##############...##...########
################...#####################################..............##############...##...########
################...#####################################..............##############...##...########
################...################..............#######..............##############...##...########
################...################..............#######..............##############...##...########
###########....................####..............#######..............##############...##...########
###########....................####..............#######..............##############...##...########
###########....................####..............#######..............##############...##...########
###########....................####..............#######..............##############...##...########
###########....................####..............#######..............##############...##...########
###########....................####..............#######..............######.......................#
###########....................####..............#######..............######.......................#
###########....................####..............#######..............######.......................#
###########....................####..............#######..............######.......................#
###########....................####..............#######..............######.......................#
###########....................####..............##############...##########.......................#
###########....................####..............##############...##########.......................#
###########....................####..............##############...##########.......................#
###########....................####..............##############...##########.......................#
###########....................####..............##############...##########.......................#
#############...###################..............##############...##########.......................#
#############...###################..............#########...............###.......................#
#############...######################...####...##########...............###.......................#
#########..............###############...####...##########...............###.......................#
#########..............###############...####...##########...............###.......................#
#########..............###############...####...##########...............###.......................#
#########..............##############..............#######...............###.......................#
#########..............##############..............#######...............###.......................#
#########..............##############..............#######...............###.......................#
#########..............##############..............#######...............###.......................#
#########..............##############..............#######...............###.......................#
#########..............##############..............#######...............###.......................#
#########..............##############..............#######...............###.......................#
#########..............##############..............#######...............###.......................#
#########..............##############..............#######...............###.......................#
#########..............##############..............#######...............###.......................#
#########..............##############..............#######...............###.......................#
#########..........................................#######...............###.......................#
#########..........................................#######...............###.......................#
#########..........................................#######...............###.......................#
#########..............##############..............#######...............###########################
#########..............#############################################################################
####################################################################################################
