##################################################
##################################################
#################################............#####
#################################............#####
#################################............#####
##.....................##########...@........#####
##.....................##########............#####
##.....................##########............#####
##.....................##########............#####
##.....................##########............#####
##.....................##########............#####
##.....................##########............#####
##.....................##########............#####
##.....................##########............#####
##.....................##########............#####
##.....................###############....########
##############...#####################....########
##############...#####################....########
##############...#####################....########
##.....................####.....................##
##.....................####.....................##
##.....................####.....................##
##.....................####.....................##
##.....................####.....................##
##.....................####.....................##
##.....................####.....................##
##.....................####.....................##
##.....................####.....................##
##.....................####.....................##
##.....................####.....................##
##.....................###############...#########
##.....................###############...#########
##.....................###############...#########
##.....................###############...#########
####...#######...#####################...#########
####...#######...#####################...#########
####...#######...#####################...#########
####...#######...###############................##
####..................##########................##
####..................##########................##
####..................##########................##
####..................##########................##
####..................##########................##
####............................................##
####............................................##
####............................................##
####..................############################
#######...............############################
##################################################
##################################################
