####################
####################
####################
##................##
##................##
##................##
##...@.........bb.##
##.............b..##
##.f..............##
##................##
##....f...........##
##................##
##................##
##................##
##................##
##.........g......##
##................##
##.b.b............##
##..b.............##
####################
