####################################################################################################
####################################################################################################
####################################################################################################
#############################....................###################################################
##...............############....................#################################...............###
##...............############....................#################################...............###
##...............############...@................#################################...............###
##...............############....................#################################...............###
##...............############....................#################################...............###
##...............############....................####.........................####...............###
##...............############....................####.........................####...............###
##...............############....................####.........................####...............###
##...............############....................####.........................####...............###
##...............############....................####.........................####...............###
##...............############....................####.........................####...............###
##...............############....................####.........................####...............###
##...............############....................####.........................####...............###
##...............############....................####.........................####...............###
##...............############....................####.........................####...............###
##...............############....................####.........................####...............###
##...............############....................####.........................####...............###
##...............############....................####............................................###
############...##############....................####............................................###
############...##############....................####............................................###
############...##############....................####.........................####...............###
############...##############....................#######...##...##################...............###
############...##############....................#######...##...##################...............###
############...#####################...#######...#######...##....................................###
############...#####################...#######...#######...##....................................###
############...#####################...#######...#######...##....................................###
############...#####################...#######...#######...#########################################
############...#####################...#######...#######...#########################################
###.................################...#######...#######...#########################################
###.................################...#######...#######...#########################################
###.................################...#######...#######...#########################################
###.................################...#######...#######...#########################################
###.............................................########...#########################################
###.............................................########...########################..............###
###.............................................#####....................##########..............###
###.................############................#####....................##########..............###
###.................############................#####....................##########..............###
###.................############................#####....................##########..............###
###.................############................#####....................##########..............###
###.................############................#####....................##########..............###
###.................############................#####....................##########..............###
###.................############................#####....................##########..............###
###......................................................................##########..............###
###......................................................................##########..............###
###..............................................................................................###
###.................############................#####............................................###
###.................############................#####............................................###
###.................############................#####....................################.....######
###.................############................########....#...#########################.....######
###.................############................########....#...#########################.....######
################################................########....#...#########################.....######
################################................########....#...#########################.....######
################################................########....#...#########################.....######
################################................########....#...#########################.....######
################################................########....#...###############....................#
################################................########..................#####....................#
#####################################...################..................#####....................#
#####################################...################..................#####....................#
#####################################...################..................#####....................#
#####################################...################..................#####....................#
#####################################...################..................#####....................#
#####################################...################..................#####....................#
##..................#################...################..................#####....................#
##..................#################...################..................#####....................#
##..................#################...################..................#####....................#
##..................................#...################..................#####....................#
##..................................#...################..................#####....................#
##..................................#...################..................#####....................#
##...................................###################..................#####....................#
##.........................................#############..................#####....................#
##.........................................#############..................#####....................#
##..................####...................#############..................#####....................#
##..................####...................#############..................#####....................#
##..................####...................#############....########################################
##..................####...................#############....########################################
##..................####...................#############....########################################
##..................####...................#############....###################...................##
##..................####...................##########....................######...................##
##..................####...................##########....................######...................##
##..................####...................##########....................######...................##
##..................####...................##########....................######...................##
##..................####...................##########....................######...................##
##..................####...................##########....................######...................##
##..................####...................##########....................######...................##
##..................####...................##########....................######...................##
##..................####...................##########....................######...................##
##..................####...................##########.............................................##
##..................####...................##########.............................................##
##..................####...................##########.............................................##
########################...................##########....................######...................##
########################...................##########....................######...................##
#####################################################.............................................##
#####################################################.............................................##
#####################################################.............................................##
#####################################################....................######...................##
####################################################################################################
