####################################################################################################
####################################################################################################
#######################################################.................############################
#######################################################.................############################
####################################...............####.................############################
####################################...............####...@.............############################
####################################...............####.................########................####
###...........................######...............####.................########................####
###...........................######...............####.................########................####
###...........................######...............####.................########................####
###...........................######...............####.................########................####
###...........................######...............####.........................................####
###...........................######...............####.........................................####
###................................................####.........................................####
###......................................................................#######................####
###......................................................................#######................####
###...........................######.....................................#######................####
###...........................######.....................................#######................####
###...........................######............................######...#######................####
###...........................########################################...#######................####
###...........................########################################...#######................####
###...........................########################################...#######................####
###...........................########################################...#######................####
###...........................########################################...#######................####
###...........................########################################...#######................####
###...........................########################################...##################...######
###...........................########################################...##################...######
###...........................############################................#################...######
###...........................############################................#################...######
###...........................############################................#################...######
###...........................########................####................#################...######
#########...##########################................####................#################...######
#########...##########################....................................#################...######
#########...##########################....................................#################...######
####.........................#########....................................#################...######
####.........................#########................####................#################...######
####.........................#########................####................###....................###
####.........................#########................####................###....................###
####.........................#########................####................###....................###
####.........................#########................####................###....................###
####.........................#########................####................###....................###
####.........................#########................####................###....................###
####.........................#########................####................###....................###
####.........................#########................####................###....................###
####.........................#########................####................###....................###
####.........................#########................####................###....................###
####.........................#########................####................###....................###
####.........................#########................####................###....................###
####.........................#########................####................###....................###
####.........................#############################................###....................###
####.........................#############################................###....................###
####.........................#############################................###....................###
####.........................#############################................###....................###
####.........................###########.........................................................###
####.........................###########.........................................................###
########################################.........................................................###
########################################...#########################################################
########################################...#########################################################
########################################...#########################################################
########################################...#########################################################
########################################...#########################################################
#######....................#########...............##########..................###...............###
#######....................#########...............##########..................###...............###
#######....................#########...............##########..................###...............###
#######....................#########...............##########..................###...............###
#######....................#########...............##########..................###...............###
#######....................#########...............##########..................###...............###
#######....................#########...............##########..................###...............###
#######........................................................................###...............###
#######........................................................................###...............###
#######..........................................................................................###
#######....................#########...............##########....................................###
#######....................#########...............##########....................................###
#######....................#########...............##########..................###...............###
#######....................#########...............##########..................###...............###
#######....................#########...............##########..................###...............###
#######....................#########...............##########..................#########...#########
#######....................#########...............##########..................#########...#########
###############...##################...............###############......################...#########
###############...#########################.....##################......################...#########
###############...#########################.....##################......################...#########
###############...#########################.....#######.....................######................##
###############...#########################.....#######.....................######................##
#######.....................####..................#####.....................######................##
#######.....................####..................#####.....................######................##
#######.....................####..................#####.....................######................##
#######.....................####..................#####.....................######................##
#######.....................####..................#####.....................######................##
#######.....................####..................#####.....................######................##
#######.....................####..................................................................##
#######.....................####..................................................................##
#######.....................####..................................................................##
#######.....................####..................#####.....................######................##
#######.....................####..................#####.....................######................##
#######.....................####..................#####.....................######................##
#######.....................####..................#####.....................######................##
#######.....................####..................#####.....................########################
#######.....................####..................#####.....................########################
#######.....................########################################################################
####################################################################################################
