####################################################################################################
####################################################################################################
##########............f.###################################................#########################
##########..............###############..............######................####....................#
##########..............###############..............######..ff....f.......####.f..................#
##########f...@.........###############..............######.f..............####....................#
##########..............###############.........f...f######................####...........f...f....#
##########........f.....###############.........f....######..f.....f.......####....................#
##########........f.....###############..............######........................................#
##########..................###########..f...........######f.................................f.....#
##########..................###########....f..f......######....f...................................#
##########..f...............###########.............f######...........f...f####....................#
##########..............#...###########......f.......######................####....................#
##########..............#...###########..............######................####....................#
##########..............#...###########..............######...........f....####....................#
##########..............#...###########..............######................####....................#
##########............f.#...###########..............######................####....................#
##########.........f....#...###########..............######................#########################
##########..............#...###########..............######...f............#########################
##########......f.......#...###########.f..........f.##################...##########################
##########..............#...###########f.............##################...##########################
##########..............#...###########.......f...f..##################...##########################
##########....f.........#...###########..............#####f.........f........#######################
################...######...###########..............#####...............f...#######################
################...######...###########..............#####............f......#######################
################...######...###########..............#####f...f..............###........f......#####
################...######...###########..............#####...................###...............#####
#############.................##################...#######...................###...............#####
#############.................##################...#######...................###........f...f..#####
#############.................##################...#######.............................f.......#####
#############........ff.f.....##################...#######..........................f..........#####
#############.................##################...#######.....................................#####
#############.................#########...............####...............f.....................#####
#############.................#########...............####................f..###...............#####
#############.................#########...............####...................###..f.........f..#####
#############.................#########..f............####...................###.........f...f.#####
#############.................#########...............####...................###...............#####
#############.................#########f............ff#################...######...............#####
#############..........f......#########...............#################...######...............#####
#############.................#########....f..........#################...#################...######
#############.................#########...............#################...#################...######
#############.........f.......#########..............f#################...#################...######
#############.................#########...............#################...#################...######
#############......f......f...........................#################...######...............#####
#############......f.........f........................#################...######...............#####
#############.........................................#################...######.............f.#####
#############.................#########...............#####.................####...........f...#####
#############..f...........f..#########..f............#####.................####......f........#####
#############.................#########...............#####....f............####......f........#####
#############.....f..f........#########...............#####..............f.....................#####
#############.................#########......f........#####....f........f................f.....#####
#############...............f.#########...............#####....................................#####
#############.................#########...............#####.................####...............#####
#############.................#########...............#####....................................#####
#############............f....#########...............#####...f................................#####
#############.......f......f..#########...............#####....................................#####
#############..............f..#########...............#####.f........f......####...............#####
#############.................#############################..f.............f####...............#####
#########################...###############################......f........f.###############...######
#########################...###############################........f........###############...######
#########################...#######################################...#...#################...######
#########################...#######################################...#...#################...######
####...........................####################################...#...#################...######
####...........................#####..............#################...#...#################...######
####...f.................f.....#####..............#################...#...###########..............#
####...........................#####f.....f.......#################...#...###########.f....f.......#
####...........................#####..............########.........f.........########............f.#
####...........................#####..............########...................########..............#
####..f...............f........#####.f.f...........................................................#
####......f.......f...................f..........................f...f...f.........................#
####.....................f.................................................f..........f............#
####..............f...................f...........########....f..............########............f.#
####.....................f.....#####..............########...................########........f.....#
####........f..................#####..............########........f..........########..............#
####..............f............#####f.............########..fff..............########..............#
####...........................#####..............########..............f....########..............#
####..f........................#####..............########....f..........f...########..............#
######################......##############...##...########...................########..............#
######################......##############...##...########................f..########..............#
######################......##############...##...########...................########....f.........#
######################......##############...##...########...................########........f.....#
######################......##############...##...########............f......########..............#
#########....................f.####................#######...................########..............#
#########......................####................##################################..............#
#########......................####................##################################..............#
#########......................####................##################################f.............#
#########......................####................##################################..............#
#########....................f.####................##################################..............#
#########......f............f..####.......f...f....##################################..............#
#########......................####...f............##################################..............#
#########.......f..............####................##################################..............#
#########...........f......f...####................##################################..............#
#########..................f...####................##################################..............#
#########......................####................##################################..............#
#########......................####................##################################..............#
#########...................f..####..f.............##################################..............#
#########......................####................##################################..............#
#########......................####....f...........#################################################
#########.............f........####................#################################################
####################################################################################################
