####################
####################
####..............##
####..............##
####..............##
####...@..........##
####..............##
####......g.......##
####..............##
####.....f..g.....##
####..............##
####..........bb..##
####..........bb..##
####..........b...##
####..............##
####......f.......##
####..............##
####..............##
####..............##
####################
