##################################################
##################################################
##################################################
##...............####.............####..........##
##...............####.............####..........##
##...............####.............####..........##
##...@...........####.............####..........##
##...............####...........................##
##...............####...........................##
##...............####...........................##
##...............####.............####..........##
##...............####...........................##
##...............####...........................##
##...............####...........................##
##...............#####################..........##
##...............#####################..........##
###########...###############################...##
###########...###############################...##
###########...###############################...##
###########...###############################...##
###########...###############################...##
###########...#######..........##############...##
###########...#######..........##############...##
###########...#######..........##############...##
###########...#######..........#######..........##
###########...#######..........#######..........##
###########...#######..........#######..........##
######..........................................##
######..........................................##
######..........................................##
##...............####...........................##
##...............####...........................##
##...............####..........#######..........##
##...............#####################..........##
##...............############################...##
##...............############################...##
##...............############################...##
##...............############################...##
##...............######..........####............#
##...............######..........####............#
##...............######..........####............#
##...............######..........####............#
#######################..........................#
#######################..........................#
#######################..........................#
#######################..........####............#
#######################..........####............#
#######################..........#################
##################################################
##################################################
