#################################################
###...........................................###
###...........................................###
###...........................................###
###...........................................###
###.............@.............................###
###...........................................###
###...........................................###
###...........................................###
###...........................................###
###...........................................###
###...........................................###
###...........................................###
###...........................................###
###...........................................###
###...........................................###
###...........................................###
###...........................................###
###...........................................###
###...........................................###
###...........................................###
###...........................................###
###...........................................###
#################################################