####################################################################################################
####################################################################################################
###############################################..............#######################################
####..............#############################..............#######################################
####..............#############################..............#######################################
####..............#############################...@...............................##################
####..............................................................................##################
####....................................................................................############
####.........................................................#####......................############
####..............#############################..............#####......................############
####..............#############################..............#####......................############
####..............#############################..............#####......................############
####..............#############################..............#####......................############
####..............#############################..............#####......................############
####..............#############################